2111111112
2000000002
2000000002
2000000002
2111111102
